University,Total HE Students,PG-Full-time,PG-Part-time,PG-Total-UK,PG-Total-Overseas,UG-Full-time,UG-Part-time,UG-Total-UK,UG-Total-Overseas,PG-Total-All,UG-Total-All
Total UK,1845757,146367,256973,314562,88778,1032897,409520,1311910,130507,403340,1442417
Total England,1533582,121140,216614,264246,73508,835526,360302,1087729,108099,337754,1195828
Anglia Polytechnic University,18577,412,2280,2312,380,10181,5704,13909,1976,2692,15885
Aston University,6384,441,1068,1006,503,4857,18,4501,374,1509,4875
Bath Spa University College,3365,325,764,1074,15,2201,75,2115,161,1089,2276
The University of Bath,8681,1063,2288,2099,1252,5330,0,4688,642,3351,5330
Birkbeck College,12607,439,2250,2478,211,14,9904,9876,42,2689,9918
The University of Birmingham,23608,3338,4420,5739,2019,13356,2494,14389,1461,7758,15850
Bishop Grosseteste College,956,43,169,193,19,744,0,743,1,212,744
Bolton Institute of Higher Education,6539,303,736,1012,27,3625,1875,5067,433,1039,5500
Bournemouth University,10788,665,756,1086,335,7684,1683,9024,343,1421,9367
The University of Bradford,11666,743,2394,2032,1105,6751,1778,7681,848,3137,8529
Bretton Hall College of HE,2788,219,323,519,23,1916,330,2227,19,542,2246
The University of Brighton,15606,897,1194,1815,276,10414,3101,11819,1696,2091,13515
The University of Bristol,18454,2112,3242,3902,1452,9600,3500,11760,1340,5354,13100
Brunel Universit y,13432,974,2922,2919,977,8662,874,8938,598,3896,9536
Buckinghamshire Chilterns University College,7943,177,682,665,194,5468,1616,6207,877,859,7084
The University of Cambridge,19877,4135,2194,3349,2980,10880,2668,12317,1231,6329,13548
Canterbury Christ Church University College,9306,625,2395,2943,77,4398,1888,6089,197,3020,6286
The University of Central England in Birmingham,19400,1174,2240,3092,322,10583,5403,14806,1180,3414,15986
The University of Central Lancashire,21589,396,1810,2063,143,11666,7717,17963,1420,2206,19383
Central School of Speech and Drama,707,153,87,207,33,466,1,432,35,240,467
Cheltenham and Gloucester College of HE,7899,355,545,865,35,5381,1618,6833,166,900,6999
Chester College of HE,6630,167,1746,1805,108,3086,1631,4632,85,1913,4717
University College Chichester,4382,200,949,1133,16,2861,372,3098,135,1149,3233
City University,15218,1655,3682,3775,1562,5106,4775,8819,1062,5337,9881
The College of Guidance Studies,147,37,53,89,1,0,57,57,0,90,57
Coventry Universit,15785,577,1150,1318,409,11291,2767,12023,2035,1727,14058
Cranfield University,3782,1615,1420,2087,948,747,0,667,80,3035,747
"Cumbria College of Art and Design, Carlisle",699,0,9,9,0,677,13,672,18,9,690
Dartington College of Arts,470,3,17,19,1,442,8,418,32,20,450
De Montfort Universit,23674,1453,2601,3536,518,15893,3727,18421,1199,4054,19620
University of Derby,12139,262,1161,1270,153,8724,1992,10221,495,1423,10716
University of Durham,12519,1362,1858,2464,756,8703,596,8743,556,3220,9299
The University of East Anglia,12951,1344,1530,2120,754,6443,3634,9159,918,2874,10077
The University of East Londo,11755,681,1979,2295,365,7657,1438,7942,1153,2660,9095
Edge Hill College of Higher Education,6624,498,706,1201,3,3954,1466,5341,79,1204,5420
The University of Essex,7208,1286,636,853,1069,4186,1100,3704,1582,1922,5286
The University of Exeter,11622,1360,1974,2529,805,7277,1011,7615,673,3334,8288
Falmouth College of Arts,1275,64,80,135,9,1081,50,997,134,144,1131
Goldsmiths College,6988,997,903,1487,413,3929,1159,4394,694,1900,5088
The University of Greenwich,16722,921,2552,2868,605,9543,3706,11772,1477,3473,13249
Harper Adams University College,1584,38,18,51,5,1452,76,1345,183,56,1528
University of Hertfordshir,17413,658,1928,2264,322,12676,2151,12988,1839,2586,14827
Homerton College,2592,454,183,599,38,1111,844,1916,39,637,1955
The University of Huddersfield,15587,797,1748,2338,207,9465,3577,12410,632,2545,13042
The University of Hull,13095,1108,1251,1508,851,7394,3342,9784,952,2359,10736
"Imperial College of Science, Technology & Medicine",10110,2789,833,2218,1404,6488,0,4839,1649,3622,6488
Institute of Advanced Nursing Education,1268,8,255,205,58,54,951,975,30,263,1005
Institute of Education,4020,1664,2318,3264,718,17,21,26,12,3982,38
The University of Keel e,10108,1019,2068,2523,564,4759,2262,6528,493,3087,7021
The University of Kent at Canterbury,10593,904,1287,1351,840,6231,2171,6717,1685,2191,8402
Kent Institute of Art & Desig,2113,67,38,45,60,1877,131,1486,522,105,2008
"King Alfred's College, Winchester",4889,108,618,713,13,3018,1145,4035,128,726,4163
King's College London,17817,2174,2925,3849,1250,11019,1699,11000,1718,5099,12718
Kingston University,14625,651,2173,2628,196,10664,1137,10344,1457,2824,11801
The University of Lancaste,10951,1168,1835,2098,905,6876,1072,6982,966,3003,7948
Leeds Metropolitan University,20943,771,2790,3221,340,11488,5894,16514,868,3561,17382
The University of Leeds,26090,2988,2985,4306,1667,16974,3143,18450,1667,5973,20117
The University of Leicester,16822,1860,6765,6469,2156,7353,844,7340,857,8625,8197
The University of Lincolnshire and Humbersid,12423,939,1007,1075,871,8245,2232,9048,1429,1946,10477
Liverpool Hope,4930,312,568,864,16,3325,725,4006,44,880,4050
Liverpool John Moores University,20593,703,2219,2599,323,13179,4492,15994,1677,2922,17671
The University of Liverpool,19600,2149,3156,3753,1552,10560,3735,13070,1225,5305,14295
London Business School,1176,727,449,426,750,0,0,0,0,1176,0
University of London (Institutes and activities)(2,1579,531,501,666,366,526,21,449,98,1032,547
London Guildhall University,12151,474,1294,1544,224,7623,2760,9122,1261,1768,10383
The London Institute,9289,591,442,742,291,7154,1102,6045,2211,1033,8256
London School of Economics and Political Science,7805,3189,1181,1244,3126,3295,140,1623,1812,4370,3435
London School of Hygiene & Tropical Medicine,689,524,165,313,376,0,0,0,0,689,0
Loughborough University,11990,1187,1756,2187,756,8865,182,8466,581,2943,9047
University of Luton,12322,311,529,655,185,7727,3755,9858,1624,840,11482
University of Mancheste r,24782,3115,3371,4118,2368,16276,2020,16428,1868,6486,18296
The University of Manchester Institute of Science & Technolo,6785,1559,298,867,990,4928,0,3759,1169,1857,4928
The Manchester Metropolitan University,30474,1664,3620,4944,340,19134,6056,23465,1725,5284,25190
Middlesex University,20691,958,2499,2506,951,15104,2130,14033,3201,3457,17234
The University of Newcastle-upon-Tyn,16678,2065,1814,2834,1045,10292,2507,11746,1053,3879,12799
Newman College,1351,41,72,108,5,1009,229,1164,74,113,1238
The University of North London,15036,803,1365,1791,377,9521,3347,11183,1685,2168,12868
North Riding College Higher Education Corporation,1346,49,29,78,0,1255,13,1241,27,78,1268
University College Northampton,10055,226,878,990,114,7326,1625,8619,332,1104,8951
Northern School of Contemporary Dance,157,0,0,0,0,157,0,135,22,0,157
The University of Northumbria at Newcastle,21254,969,2450,3014,405,13222,4613,16215,1620,3419,17835
Norwich School of Art and Design,672,5,17,21,1,648,2,623,27,22,650
The Nottingham Trent Universit,22011,938,2139,2803,274,15611,3323,17813,1121,3077,18934
The University of Nottingham,22525,2460,2936,3680,1716,12430,4699,15566,1563,5396,17129
The Open University,148675,451,31307,31758,0,0,116917,116917,0,31758,116917
Oxford Brookes University,13175,1124,1544,2091,577,8233,2274,8761,1746,2668,10507
The University of Oxfor d,20791,4402,1590,3015,2977,11571,3228,13252,1547,5992,14799
The University of Plymouth,21079,555,1921,2218,258,14661,3942,17348,1255,2476,18603
The University of Portsmouth,16389,671,2004,2236,439,11745,1969,11515,2199,2675,13714
Queen Mary and Westfield College,8825,1269,755,1372,652,6618,183,5673,1128,2024,6801
Ravensbourne College of Design and Communication,602,0,0,0,0,602,0,529,73,0,602
The University of Reading,13284,2022,2946,3552,1416,7295,1021,7317,999,4968,8316
The College of Ripon and York St John,4082,148,286,417,17,2965,683,3480,168,434,3648
"University of Surrey, Roehampton",7076,553,589,1006,136,5071,863,5596,338,1142,5934
Rose Bruford College,841,0,54,50,4,517,270,657,130,54,787
Royal Academy of Music,588,275,0,131,144,313,0,211,102,275,313
Royal College of Art,821,768,53,603,218,0,0,0,0,821,0
Royal College of Music,503,123,13,75,61,367,0,280,87,136,367
Royal Holloway and Bedford New College,5971,711,559,867,403,4665,36,3715,986,1270,4701
Royal Northern College of Music,591,136,0,85,51,455,0,386,69,136,455
The Royal Veterinary College,713,102,66,104,64,545,0,456,89,168,545
St George's Hospital Medical School,2423,39,477,477,39,985,922,1838,69,516,1907
College of St Mark and St John,3121,248,695,913,30,2158,20,2056,122,943,2178
St Martin's College,8047,572,2021,2514,79,3544,1910,5369,85,2593,5454
St Mary's College,2799,148,183,317,14,2185,283,2153,315,331,2468
The University of Salford,19269,915,2431,2600,746,12286,3637,14481,1442,3346,15923
The School of Oriental and African Studies,3910,1023,1093,984,1132,1789,5,1151,643,2116,1794
The School of Pharmacy,794,107,250,307,50,434,3,342,95,357,437
Sheffield Hallam University,22925,1264,2997,3616,645,15933,2731,17898,766,4261,18664
The University of Sheffield,26348,3353,3309,5038,1624,15683,4003,17980,1706,6662,19686
South Bank University,21921,1465,3650,4658,457,10880,5926,15224,1582,5115,16806
Southampton Institute,11360,152,542,634,60,8823,1843,9710,956,694,10666
The University of Southampton,20449,2165,2690,3576,1279,12472,3122,14588,1006,4855,15594
Staffordshire University,16607,600,921,1263,258,11756,3330,13992,1094,1521,15086
The University of Sunderland,13427,445,934,1188,191,9291,2757,10842,1206,1379,12048
"The Surrey Institute of Art and Design, University College",2460,22,16,24,14,2324,98,2093,329,38,2422
The University of Surre y,12258,1639,2573,2708,1504,5118,2928,6856,1190,4212,8046
The University of Sussex,12169,1489,1293,1829,953,6986,2401,7706,1681,2782,9387
The University of Teesside,11472,268,1017,1211,74,7367,2820,9668,519,1285,10187
Thames Valley University,14145,363,1245,1512,96,7237,5300,11279,1258,1608,12537
Trinity And All Saints College,2411,167,146,303,10,2014,84,2011,87,313,2098
Trinity College of Music,498,93,45,94,44,360,0,300,60,138,360
University College London,18609,4232,3439,5143,2528,10541,397,8928,2010,7671,10938
The University of Warwick,17315,2640,3385,4236,1789,8117,3173,9796,1494,6025,11290
"University of the West of England, Bristo",23308,1003,2705,3437,271,15225,4375,18288,1312,3708,19600
Westhill College,1323,107,118,180,45,818,280,1065,33,225,1098
Westminster College,1801,175,635,749,61,577,414,970,21,810,991
The University of Westminster,20408,1402,3897,4418,881,9385,5724,13264,1845,5299,15109
Wimbledon School of Art,506,13,88,85,16,405,0,361,44,101,405
The University of Wolverhampton,22607,725,2353,2705,373,13377,6152,16671,2858,3078,19529
University College Worcester,4597,227,202,424,5,2937,1231,4122,46,429,4168
Writtle College,1200,1,36,30,7,1004,159,1005,158,37,1163
Wye College,976,290,191,234,247,495,0,452,43,481,495
The University of York,8367,1292,812,1424,680,5292,971,5748,515,2104,6263
Total Wales,96527,7112,10772,13630,4254,58819,19824,72203,6440,17884,78643
"University of Wales, Aberystwyth",9950,809,1505,1748,566,5918,1718,7002,634,2314,7636
"University of Wales, Bango",8786,835,1310,1206,939,5519,1122,6169,472,2145,6641
Cardiff University,18857,2542,1393,2592,1343,11919,3003,13570,1352,3935,14922
"University of Wales Institute, Cardif",7729,484,680,1028,136,5255,1310,6140,425,1164,6565
University of Glamorgan,16709,573,1776,2053,296,9573,4787,13086,1274,2349,14360
"The University of Wales, Lampete",2038,118,242,241,119,1259,419,1494,184,360,1678
University of Wales College of Medicine,2883,129,598,588,139,2022,134,2035,121,727,2156
"University of Wales College, Newport",7100,219,797,948,68,2710,3374,5716,368,1016,6084
The North-East Wales Institute of Higher Education,4258,40,366,382,24,2499,1353,3577,275,406,3852
Swansea Institute of Higher Educatio,4455,19,485,493,11,2973,978,3783,168,504,3951
"University of Wales, Swansea",11961,1210,1545,2157,598,7609,1597,8138,1068,2755,9206
"Trinity College, Carmarthen",1255,133,65,185,13,1056,1,995,62,198,1057
Welsh College of Music and Drama,546,1,10,9,2,507,28,498,37,11,535
Total Scotland,172923,14651,24230,29298,9583,113700,20342,122269,11773,38881,134042
The University of Aberdeen,11369,1174,1043,1451,766,8298,854,8006,1146,2217,9152
University of Abertay Dundee,3975,335,232,457,110,3133,275,3089,319,567,3408
The University of Dunde,11439,657,1910,1959,608,7307,1565,8171,701,2567,8872
Edinburgh College of Art,1720,264,100,257,107,1356,0,1208,148,364,1356
The University of Edinburgh,22122,2524,2803,3855,1472,15590,1205,14971,1824,5327,16795
Glasgow Caledonian University,14929,850,1285,1801,334,10222,2572,12103,691,2135,12794
Glasgow School of Art,1423,89,19,74,34,1282,33,1152,163,108,1315
The University of Glasgow,21714,1734,1758,2690,802,14521,3701,16700,1522,3492,18222
Heriot-Watt University,7166,706,1567,1691,582,4597,296,4163,730,2273,4893
Napier University,10920,773,802,1381,194,7523,1822,8567,778,1575,9345
Northern College of Education,2918,211,1510,1612,109,891,306,1170,27,1721,1197
The University of Paisley,9634,622,528,1052,98,5780,2704,8160,324,1150,8484
"Queen Margaret University College, Edinburgh",3451,94,215,247,62,2611,531,2807,335,309,3142
The Robert Gordon University,9822,490,1089,1363,216,6633,1610,7487,756,1579,8243
The Royal Scottish Academy of Music and Drama,552,58,24,58,24,470,0,443,27,82,470
St Andrew's College of Education,1232,188,535,693,30,509,0,504,5,723,509
The University of St Andrews,6015,661,310,671,300,4837,207,4340,704,971,5044
Scottish Agricultural College,937,58,12,62,8,865,2,818,49,70,867
The University of Stirlin,7864,711,700,975,436,5607,846,5905,548,1411,6453
The University of Strathclyde,23721,2452,7788,6949,3291,11668,1813,12505,976,10240,13481
Total Northern Ireland,42725,3464,5357,7388,1433,24852,9052,29709,4195,8821,33904
The Queen's University of Belfast(3,23085,2096,2355,3731,720,12756,5878,16586,2048,4451,18634
University of Ulster,19640,1368,3002,3657,713,12096,3174,13123,2147,4370,15270
