University,Total HE students,PG-Full-time,PG-Part-time,PG-Total-UK,PG-Total-All,PG-Total-Overseas,UG-Full-time,UG-Part-time,UG-Total-UK,UG-Total-Overseas,UG-Total-All
Total UK,1856330,151330,257290,313140,408620,95480,1027400,420310,1318530,129180,1447710
Total England,1540610,125490,216800,262430,342290,79860,830430,367900,1091130,107200,1198330
Anglia Polytechnic University,19250,460,2650,2540,3120,580,9680,6450,14170,1960,16130
Aston University,6580,490,1300,1230,1790,560,4780,10,4400,390,4790
Bath Spa University College,3750,440,800,1210,1240,30,2370,150,2370,150,2520
The University of Bath,9770,1130,2830,2570,3970,1400,5800,10,5100,710,5810
Birkbeck College,12670,540,2360,2600,2890,290,10,9770,9750,30,9780
The University of Birmingham,25550,2950,5780,6310,8720,2410,13960,2860,15280,1550,16830
Bishop Grosseteste College,1000,20,200,200,220,20,770,0,770,0,770
Bolton Institute of Higher Education,6800,440,800,1170,1230,60,3390,2170,5150,410,5560
Bournemouth University,11440,810,740,1040,1550,510,7930,1970,9450,440,9890
The University of Bradford,11390,710,2300,1950,3010,1060,6380,2000,7620,760,8380
Bretton Hall College of HE,2650,170,230,380,400,20,1850,400,2230,20,2250
The University of Brighton,15640,670,1390,1800,2050,250,10470,3120,11570,2020,13590
The University of Bristol,17920,1820,3540,3950,5370,1420,9360,3190,11350,1210,12560
Brunel University,13770,1210,2740,2840,3940,1100,8570,1250,9180,650,9830
Buckinghamshire Chilterns University College,8070,170,600,640,780,140,5790,1510,6410,890,7300
The University of Cambridge,20300,4220,2350,3470,6580,3110,11000,2730,12440,1290,13730
Canterbury Christ Church University College,10520,680,2940,3520,3620,100,4400,2500,6700,200,6900
The University of Central England in Birmingham,19350,1170,2110,2920,3280,360,10540,5540,14850,1220,16070
The University of Central Lancashire,23440,430,1830,2080,2260,180,13300,7880,19790,1400,21190
Central School of Speech and Drama,690,220,60,230,270,40,420,0,380,40,420
Cheltenham and Gloucester College of HE,8040,390,540,870,930,60,5570,1540,6910,190,7100
Chester College of HE,6420,180,1490,1630,1670,40,3430,1320,4680,80,4760
University College Chichester,3490,170,410,560,590,30,2600,300,2790,120,2910
City University,14970,1700,3680,3780,5370,1590,4950,4640,8430,1160,9590
The College of Guidance Studies,130,20,40,70,70,0,0,60,60,0,60
Coventry University,15320,670,1140,1320,1810,490,10850,2660,11650,1860,13510
Cranfield University,3410,1600,1090,1860,2690,830,720,0,650,70,720
"Cumbria College of Art and Design, Carlisle",680,0,0,0,0,0,660,20,640,30,670
Dartington College of Arts,500,10,30,40,40,0,440,10,410,50,460
De Montfort University,22260,1400,2460,3340,3860,520,15540,2860,17300,1100,18400
University of Derby,11430,220,970,1120,1190,70,8400,1840,9980,260,10240
University of Durham,13000,1430,1930,2520,3360,840,9010,630,8980,660,9640
The University of East Anglia,12370,1520,1460,2220,2980,760,6500,2880,8480,900,9380
The University of East London,12380,880,2070,2420,2940,520,7880,1550,7950,1490,9440
Edge Hill College of Higher Education,6740,400,610,1010,1010,0,4180,1550,5650,80,5730
The University of Essex,7430,1260,800,880,2070,1190,4380,990,3850,1520,5370
The University of Exeter,11770,1490,2040,2560,3530,970,7270,970,7570,670,8240
Falmouth College of Arts,1290,60,70,120,120,0,1120,50,1060,110,1170
Goldsmiths College,7010,1100,900,1490,2000,510,3840,1180,4240,780,5020
The University of Greenwich,16870,1100,2700,2880,3800,920,9610,3460,11520,1550,13070
Harper Adams University College,1650,60,40,90,110,20,1470,80,1350,200,1550
University of Hertfordshire,17310,810,1560,1980,2370,390,12640,2300,13210,1730,14940
Homerton College,3050,450,120,540,560,20,1220,1270,2450,50,2500
The University of Huddersfield,16260,860,1930,2550,2800,250,9570,3900,12810,650,13460
The University of Hull,14050,1150,1780,1830,2930,1100,7480,3640,10000,1110,11110
"Imperial College of Science, Technology & Medicine",10530,2850,910,2320,3760,1440,6780,0,5170,1610,6780
Institute of Advanced Nursing Education,1180,0,220,210,210,0,40,920,940,20,960
Institute of Education,4340,1630,2670,3570,4300,730,10,30,40,0,40
The University of Keele,9780,880,1850,2220,2730,510,4740,2310,6610,440,7050
The University of Kent at Canterbury,10710,950,790,1050,1740,690,6310,2670,7370,1610,8980
Kent Institute of Art & Design,1920,40,20,20,50,30,1740,130,1350,510,1860
"King Alfred's College, Winchester",4870,130,560,660,680,20,3020,1170,4040,140,4180
King's College London,18110,2330,3040,3880,5380,1500,10910,1820,11070,1660,12730
Kingston University,14500,660,2040,2450,2700,250,10640,1160,10360,1440,11800
The University of Lancaster,11190,1230,1770,2080,3000,920,7050,1140,7170,1020,8190
Leeds Metropolitan University,21950,710,2570,2860,3280,420,11780,6900,17430,1250,18680
The University of Leeds,26400,3120,2960,4360,6080,1720,17110,3200,18620,1700,20320
The University of Leicester,17150,1880,7370,6670,9250,2580,7300,610,7140,770,7910
The University of Lincolnshire and Humberside,12450,930,1170,1200,2100,900,7960,2390,8860,1490,10350
Liverpool Hope,5530,350,660,980,1000,20,3550,980,4420,110,4530
Liverpool John Moores University,19970,630,2180,2490,2820,330,13260,3900,15590,1570,17160
The University of Liverpool,20010,2310,2570,3380,4880,1500,10980,4150,14130,1000,15130
London Business School,1240,760,470,470,1230,760,0,0,0,0,0
University of London (Institutes and activities)(2),1180,400,330,500,740,240,190,260,400,50,450
London Guildhall University,12140,430,1340,1530,1780,250,7610,2760,9140,1230,10370
The London Institute,9780,670,560,840,1220,380,7540,1020,6120,2430,8550
London School of Economics and Political Science,7710,3290,920,1220,4210,2990,3330,170,1660,1840,3500
London School of Hygiene & Tropical Medicine,750,590,170,340,750,410,0,0,0,0,0
Loughborough University,12270,1300,1940,2470,3240,770,8840,190,8500,530,9030
University of Luton,13410,490,1070,890,1560,670,7500,4350,9720,2120,11840
University of Manchester,25580,3360,3610,4370,6970,2600,16400,2220,16920,1700,18620
The University of Manchester Institute of Science & Technology,6660,1370,300,750,1670,920,5000,0,3910,1080,4990
The Manchester Metropolitan University,30070,2060,3870,5510,5930,420,18620,5520,22470,1670,24140
Middlesex University,20950,1550,2400,2780,3950,1170,14510,2500,14060,2940,17000
The University of Newcastle-upon-Tyne,16950,2020,2070,2950,4090,1140,10070,2780,11860,1000,12860
Newman College,1390,40,40,80,80,0,930,380,1210,100,1310
The University of North London,14570,790,1530,1820,2310,490,8960,3300,10400,1850,12250
North Riding College Higher Education Corporation,1360,60,40,90,90,0,1220,40,1230,40,1270
University College Northampton,9760,280,850,1000,1130,130,6940,1680,8300,320,8620
Northern School of Contemporary Dance,140,0,0,0,0,0,140,0,110,30,140
The University of Northumbria at Newcastle,21560,1010,2360,2850,3360,510,13720,4470,16500,1690,18190
Norwich School of Art and Design,680,20,20,30,30,0,650,0,630,20,650
The Nottingham Trent University,20970,880,2280,2820,3150,330,14640,3180,16930,890,17820
The University of Nottingham,23540,2630,3360,4090,5990,1900,13440,4100,15810,1730,17540
The Open University,153730,450,30060,30520,30520,0,0,123220,123220,0,123220
Oxford Brookes University,13390,1230,1780,2310,3010,700,8570,1810,8750,1630,10380
The University of Oxford,21670,4480,1590,3000,6070,3070,11780,3820,13990,1600,15590
The University of Plymouth,21880,580,2110,2410,2690,280,14610,4580,17890,1300,19190
The University of Portsmouth,16240,770,2070,2320,2850,530,11320,2080,11300,2100,13400
Queen Mary and Westfield College,9010,1400,790,1510,2190,680,6680,150,5820,1010,6830
Ravensbourne College of Design and Communication,690,0,0,0,0,0,690,0,580,110,690
The University of Reading,13390,1990,3000,3510,4990,1480,7390,1010,7310,1090,8400
The College of Ripon and York St John,4120,180,360,540,540,0,2970,610,3420,160,3580
"University of Surrey, Roehampton",7240,610,580,1030,1190,160,5260,800,5580,480,6060
Rose Bruford College,900,20,50,60,70,10,550,270,680,140,820
Royal Academy of Music,600,270,0,120,270,150,340,0,230,110,340
Royal College of Art,830,760,60,610,830,220,0,0,0,0,0
Royal College of Music,560,170,20,90,190,100,370,0,280,90,370
Royal Holloway and Bedford New College,6030,840,550,940,1390,450,4610,40,3680,970,4650
Royal Northern College of Music,580,150,0,100,150,50,430,0,370,70,440
The Royal Veterinary College,770,100,70,110,170,60,600,0,500,100,600
St George's Hospital Medical School,2660,50,440,450,490,40,1090,1090,2090,90,2180
College of St Mark and St John,3180,270,630,870,890,20,2260,30,2090,190,2280
St Martin's College,7600,550,1200,1620,1760,140,3670,2180,5770,70,5840
St Mary's College,3150,190,290,470,480,10,2160,520,2280,400,2680
The University of Salford,19730,1060,2750,2900,3810,910,11940,3990,14420,1500,15920
The School of Oriental and African Studies,3730,1120,730,920,1850,930,1840,40,1190,690,1880
The School of Pharmacy,780,90,250,300,350,50,420,10,340,90,430
Sheffield Hallam University,23580,1280,3070,3470,4350,880,16040,3190,18290,950,19240
The University of Sheffield,23530,3390,3230,4930,6620,1690,14320,2600,15420,1500,16920
South Bank University,15030,990,2090,2680,3080,400,7460,4490,10960,990,11950
Southampton Institute,10900,230,610,700,840,140,8570,1490,9280,780,10060
The University of Southampton,20790,2350,2610,3470,4960,1490,13050,2770,14900,920,15820
Staffordshire University,16470,620,1320,1630,1950,320,11120,3410,13620,900,14520
The University of Sunderland,12510,640,820,1180,1460,280,8500,2550,9980,1070,11050
"The Surrey Institute of Art and Design, University College",2500,20,30,30,50,20,2350,100,2120,330,2450
The University of Surrey,11460,1450,2420,2560,3870,1310,5140,2440,6410,1170,7580
The University of Sussex,11360,1420,1280,1750,2700,950,6800,1860,7150,1510,8660
The University of Teesside,12940,490,1100,1490,1590,100,7270,4090,10830,520,11350
Thames Valley University,12880,290,1220,1410,1500,90,6300,5070,10210,1170,11380
Trinity And All Saints College,2500,140,220,350,350,0,2090,50,2050,90,2140
Trinity College of Music,560,120,50,120,170,50,380,0,300,80,380
University College London,17750,4080,3070,4800,7160,2360,10380,210,8660,1940,10600
The University of Warwick,18540,2480,4210,4180,6690,2510,8400,3450,10280,1570,11850
"University of the West of England, Bristol",22360,1190,1720,2640,2910,270,15930,3520,18310,1150,19460
Westminster College,1540,130,400,430,540,110,480,530,890,120,1010
The University of Westminster,21300,1850,4030,4750,5890,1140,9440,5980,13270,2150,15420
Wimbledon School of Art,520,30,80,90,110,20,410,0,350,60,410
The University of Wolverhampton,21480,750,2150,2560,2900,340,12880,5700,16570,2010,18580
University College Worcester,5310,270,340,600,610,10,3140,1560,4620,90,4710
Writtle College,1130,20,40,40,50,10,910,160,910,160,1070
Wye College,900,260,160,200,430,230,480,0,440,40,480
The University of York,8740,1370,920,1570,2300,730,5560,880,5830,620,6450
Total Wales,99090,7340,11020,14120,18360,4240,58640,22090,74320,6420,80740
"University of Wales, Aberystwyth",10200,800,1390,1710,2190,480,6020,2000,7400,610,8010
"University of Wales, Bangor",8850,860,1140,1210,2000,790,5500,1350,6400,450,6850
Cardiff University,19150,2610,1510,2700,4120,1420,12140,2890,13650,1380,15030
"University of Wales Institute, Cardiff",7580,520,680,1050,1200,150,5230,1140,5930,440,6370
University of Glamorgan,17100,650,1850,2140,2510,370,9490,5100,13380,1220,14600
"The University of Wales, Lampeter",2800,90,370,310,460,150,1160,1180,2100,240,2340
University of Wales College of Medicine,3200,150,780,760,940,180,2030,240,2130,140,2270
"University of Wales College, Newport",7610,270,1070,1190,1340,150,2550,3720,5830,430,6260
The North-East Wales Institute of Higher Education,4510,30,380,380,410,30,2470,1630,3800,300,4100
Swansea Institute of Higher Education,4360,30,440,460,470,10,2980,900,3720,160,3880
"University of Wales, Swansea",11530,1160,1310,1960,2470,510,7460,1590,8070,980,9050
"Trinity College, Carmarthen",1660,150,90,230,230,0,1100,320,1380,50,1430
Welsh College of Music and Drama,560,0,0,10,10,0,500,40,510,40,550
Total Scotland,173520,15120,23410,28790,38520,9730,113430,21570,122870,12120,134990
The University of Aberdeen,11180,1140,1060,1410,2200,790,8110,880,7780,1210,8990
University of Abertay Dundee,4050,300,180,370,480,110,3320,250,3260,310,3570
The University of Dundee,11450,590,1980,1970,2570,600,7300,1580,8200,680,8880
Edinburgh College of Art,1660,260,80,240,340,100,1310,0,1150,160,1310
The University of Edinburgh,22170,2550,2070,3210,4620,1410,15200,2350,15600,1950,17550
Glasgow Caledonian University,14730,860,1250,1780,2120,340,10050,2560,11960,650,12610
Glasgow School of Art,1610,110,30,90,140,50,1440,30,1200,270,1470
The University of Glasgow,22700,1930,2070,3200,4000,800,14870,3830,17300,1400,18700
Heriot-Watt University,6920,810,1340,1510,2140,630,4650,130,4000,780,4780
Napier University,10570,820,820,1410,1650,240,7360,1570,8160,760,8920
Northern College of Education,2930,260,1390,1560,1650,90,840,440,1260,20,1280
The University of Paisley,9550,700,590,1220,1290,70,5770,2490,7910,350,8260
"Queen Margaret University College, Edinburgh",3700,120,230,290,350,60,2710,640,3000,350,3350
The Robert Gordon University,10040,680,1180,1500,1860,360,6630,1560,7480,700,8180
The Royal Scottish Academy of Music and Drama,610,70,30,70,100,30,510,0,480,30,510
The University of St Andrews,6350,690,250,660,940,280,5130,280,4510,900,5410
Scottish Agricultural College,860,70,0,70,70,0,780,0,740,40,780
The University of Stirling,8100,770,770,1080,1540,460,5720,840,6060,500,6560
The University of Strathclyde,24350,2420,8060,7160,10480,3320,11730,2140,12810,1060,13870
Total Northern Ireland,43110,3380,6070,7800,9440,1640,24910,8760,30220,3440,33660
The Queen's University of Belfast,20850,1860,2620,3730,4480,750,11180,5200,14920,1460,16380
St Mary's University College,850,10,150,150,150,0,630,60,650,40,690
Stranmillis University College,1080,20,120,130,130,0,700,250,900,60,960
University of Ulster,20330,1490,3190,3800,4680,880,12400,3250,13760,1890,15650
