university,Total HE students,PG-Total-All,PG-Full-time,PG-Part-time,PG-Total-UK,PG-Total-Overseas,UG-Total-All,UG-Full-time,UG-Part-time,UG-Total-UK,UG-Total-Overseas
Total UK,2306105,501135,248380,252755,333655,167480,1804970,1232005,572965,1630660,174310
Total England,1922180,417165,206865,210300,277915,139250,1505015,1011955,493060,1360015,145000
Anglia Ruskin University,19005,2305,715,1595,1870,435,16700,9415,7285,15280,1420
Aston University,9570,2415,1610,800,1065,1350,7155,6825,330,6000,1155
Bath Spa University,7470,2585,655,1935,2545,40,4880,4360,525,4750,130
The University of Bath,12965,3890,1515,2375,2485,1405,9075,8745,330,7165,1910
University of Bedfordshire,14195,1995,1005,990,920,1075,12200,8085,4115,9935,2265
Birkbeck College(#11),17225,3075,725,2350,2605,470,14150,165,13980,13420,730
Birmingham City University,23245,3485,1320,2165,2615,870,19760,13695,6065,18755,1005
The University of Birmingham,28240,10210,5475,4735,6720,3490,18030,16055,1975,16390,1640
University College Birmingham(#10),3920,375,295,75,85,290,3545,2670,875,2915,630
Bishop Grosseteste University College Lincoln,1915,600,80,520,575,25,1315,1315,5,1315,0
The University of Bolton,7845,1465,640,825,1180,285,6380,3735,2645,5890,490
The Arts Institute at Bournemouth,2000,20,20,0,15,5,1980,1885,100,1795,185
Bournemouth University,17875,2280,1395,885,1185,1095,15595,11260,4335,14665,930
The University of Bradford,12375,3040,1430,1610,1645,1395,9335,8045,1290,7565,1770
The University of Brighton,21220,4105,1505,2600,3250,855,17115,12995,4120,15385,1730
The University of Bristol,17810,4840,3085,1755,3065,1775,12970,12135,835,11570,1400
Brunel University,14265,3860,2320,1540,2000,1860,10405,9740,665,9310,1095
Buckinghamshire New University,9265,605,170,435,440,165,8660,4970,3690,7635,1025
The University of Buckingham,985,260,235,25,100,160,725,675,45,265,460
The University of Cambridge,22745,7060,5695,1365,3735,3325,15685,11760,3925,13785,1900
The Institute of Cancer Research(#11),300,300,105,195,225,75,0,0,0,0,0
Canterbury Christ Church University,15545,3715,1250,2460,3400,315,11835,7330,4505,11055,780
The University of Central Lancashire(#9),31245,3925,1785,2140,3035,890,27325,18035,9285,22355,4970
Central School of Speech and Drama(#11),880,310,270,35,235,75,570,570,0,535,35
University of Chester,13515,2975,580,2400,2800,175,10540,7565,2975,10335,205
The University of Chichester,4805,1010,280,725,1000,10,3795,3075,720,3660,135
The City University,21410,6880,4460,2420,3875,3005,14530,7835,6695,12225,2305
Conservatoire for Dance and Drama,1140,75,40,35,50,25,1065,1055,10,800,265
Courtauld Institute of Art(#11),440,280,255,25,160,120,160,160,0,135,25
Coventry University,20375,3540,1880,1660,1790,1750,16835,11560,5275,14890,1945
Cranfield University,4580,4580,2765,1815,2360,2220,0,0,0,0,0
University for the Creative Arts(#10),5430,275,185,90,140,135,5155,4920,240,4585,570
University of Cumbria(#9)(#10),12045,2165,1090,1075,2055,110,9875,5360,4515,9635,240
Dartington College of Arts(#12),625,65,15,50,55,10,565,555,10,535,30
De Montfort University,20395,3270,830,2440,2575,695,17125,14080,3040,16300,825
University of Derby,16145,3135,590,2545,2700,435,13010,9330,3685,12035,975
University of Durham,16275,4635,3115,1520,2645,1990,11640,11275,365,10675,965
The University of East Anglia,15695,2850,2135,715,1760,1090,12845,9790,3055,11685,1160
The University of East London,19430,5010,2640,2365,3305,1705,14420,11005,3415,12750,1670
Edge Hill University,20140,7335,720,6610,7270,65,12805,6410,6395,12690,115
The University of Essex,11510,2695,1765,935,1370,1325,8810,7455,1360,6990,1820
The University of Exeter,14705,4055,2770,1285,2705,1350,10650,10010,640,9745,905
University College Falmouth(#12),2320,200,120,80,175,25,2120,2065,55,2025,95
University of Gloucestershire,8515,1820,530,1290,1680,140,6700,5580,1120,6330,370
Goldsmiths College(#11),7495,2215,1430,785,1445,770,5280,4520,765,4605,675
The University of Greenwich,24505,5400,2030,3370,2975,2425,19105,13025,6080,16650,2455
Guildhall School of Music and Drama,795,275,195,80,140,135,520,520,0,365,155
Harper Adams University College,4220,105,35,75,70,35,4110,1545,2565,3930,180
University of Hertfordshire,22835,4050,2025,2025,2510,1540,18785,15685,3100,16655,2130
Heythrop College(#11),745,360,40,325,325,35,380,370,10,350,30
The University of Huddersfield,20430,3650,1060,2590,3100,550,16780,11595,5185,15850,930
The University of Hull,21005,2690,1620,1070,1630,1060,18315,11015,7300,16790,1525
"Imperial College of Science, Technology and Medicine",13845,5310,4125,1185,2905,2405,8535,8535,0,5575,2960
Institute of Education(#11),7385,7075,1810,5265,5995,1080,310,90,215,235,75
The University of Keele,11415,2380,810,1570,1770,610,9035,6325,2710,8440,595
The University of Kent,17805,2645,1355,1295,1820,825,15160,11390,3770,13170,1990
King's College London(#11),21110,6995,4100,2900,4725,2270,14110,11635,2475,12230,1880
Kingston University,23985,5075,2110,2965,3505,1570,18910,16760,2150,16555,2355
The University of Lancaster,13720,3495,1985,1505,2075,1420,10230,7790,2440,9005,1225
Leeds College of Music,700,25,10,15,20,5,675,675,0,645,30
Leeds Metropolitan University,27215,3905,1420,2485,2900,1005,23310,17115,6195,22275,1035
The University of Leeds,32250,8405,5800,2605,4760,3645,23845,21895,1950,22260,1585
Leeds Trinity and All Saints,3005,400,270,130,370,30,2605,2205,405,2515,90
The University of Leicester,15355,5760,2380,3380,4065,1695,9595,8000,1595,8420,1175
The University of Lincoln,11640,1120,440,675,885,235,10525,8280,2245,9835,690
Liverpool Hope University,7060,1395,755,635,1150,245,5665,4390,1275,5375,290
Liverpool John Moores University,24445,4465,1795,2670,3390,1075,19980,15115,4865,18390,1590
The Liverpool Institute for Performing Arts,885,65,15,50,60,5,820,640,185,680,140
The University of Liverpool,19380,2970,1980,985,1760,1210,16410,13265,3145,15125,1285
"University of the Arts, London",15360,2610,1760,845,1445,1165,12750,12100,655,8755,3995
London Business School(#11),1555,1555,930,625,500,1055,0,0,0,0,0
University of London (Institutes and activities)(#11),290,290,175,120,180,110,0,0,0,0,0
London Metropolitan University,27975,7055,2480,4575,4360,2695,20920,12840,8080,17240,3680
London South Bank University,22340,5625,1440,4190,4270,1355,16710,10085,6625,14965,1745
London School of Economics and Political Science(#11),9105,5185,4690,495,955,4230,3920,3860,60,1980,1940
London School of Hygiene and Tropical Medicine(#11),1100,1100,625,475,545,555,0,0,0,0,0
Loughborough University,16645,5185,3505,1680,2425,2760,11460,11170,295,10340,1120
The Manchester Metropolitan University,32965,5330,2370,2960,4480,850,27635,24090,3545,25580,2055
The University of Manchester,37360,10515,6940,3575,6200,4315,26845,24930,1920,22785,4060
Middlesex University,21625,4750,1705,3045,2620,2130,16875,12755,4120,14260,2615
The University of Newcastle-upon-Tyne,19050,4665,3305,1360,2670,1995,14385,14165,220,12920,1465
Newman University College(#10),2685,210,30,180,200,10,2475,1820,655,2420,55
The University of Northampton,11585,1775,580,1200,1285,490,9805,6885,2920,9260,545
The University of Northumbria at Newcastle,29995,6750,3045,3705,4050,2700,23245,16760,6485,20640,2605
Norwich University College of the Arts(#10),1220,115,20,95,115,0,1105,1105,0,1085,20
The University of Nottingham,31830,7960,5950,2010,3925,4035,23865,20965,2905,20415,3450
The Nottingham Trent University,23505,4760,2480,2275,3570,1190,18745,15945,2805,17605,1140
The Open University(#9),181695,15165,405,14760,14970,195,166530,5,166520,166395,135
Oxford Brookes University,18035,3940,1460,2480,2935,1005,14095,11310,2785,12130,1965
The University of Oxford,23985,7925,6905,1015,3550,4375,16060,11450,4610,14015,2045
University College Plymouth St Mark and St John,3750,1615,275,1340,1490,125,2135,2060,75,2035,100
The University of Plymouth,29375,3660,1060,2600,3045,615,25715,17750,7965,24415,1300
The University of Portsmouth,19560,3580,1270,2305,2350,1230,15980,13330,2650,14490,1490
Queen Mary and Westfield College(#11),13610,3295,2205,1090,1755,1540,10315,10250,65,8695,1620
Ravensbourne College of Design and Communication,1010,0,0,0,0,0,1010,1010,0,895,115
The University of Reading,14470,3760,2060,1705,2285,1475,10710,8855,1855,9620,1090
Roehampton University,8235,1800,1030,770,1415,385,6435,5875,560,6045,390
Rose Bruford College,955,45,15,30,30,15,910,655,255,810,100
Royal Academy of Music(#11),730,410,410,0,215,195,320,320,0,200,120
Royal Agricultural College,880,200,170,30,105,95,680,650,30,635,45
Royal College of Art,950,950,905,45,575,375,0,0,0,0,0
Royal College of Music,615,265,245,25,130,135,350,350,0,220,130
Royal Holloway and Bedford New College(#11),8385,1825,1380,445,1035,790,6560,6115,440,4860,1700
Royal Northern College of Music,695,205,200,5,115,90,490,490,0,410,80
The Royal Veterinary College(#11),1795,365,215,155,290,75,1430,1400,25,1325,105
St George's Hospital Medical School(#11),4160,455,60,395,315,140,3705,2280,1425,3490,215
"St Mary's University College, Twickenham",4145,830,315,510,755,75,3320,2790,530,3045,275
The University of Salford,19180,3530,1620,1910,2225,1305,15650,12385,3265,14250,1400
The School of Oriental and African Studies(#11),4730,1955,1495,460,905,1050,2775,2695,85,1750,1025
The School of Pharmacy(#11),1230,525,155,370,410,115,705,670,35,595,110
Sheffield Hallam University,31090,7555,2575,4980,5340,2215,23535,18410,5125,22015,1520
The University of Sheffield,24560,6785,5285,1500,3615,3170,17775,15980,1790,16160,1615
Southampton Solent University,10850,720,330,390,430,290,10130,8900,1230,8850,1280
The University of Southampton,23765,6340,4270,2070,3955,2385,17425,14785,2635,15690,1735
Staffordshire University,15735,3055,965,2090,2170,885,12680,8345,4335,11965,715
University Campus Suffolk(#9),4275,195,5,190,195,0,4080,2300,1780,4040,40
The University of Sunderland,17710,2665,1595,1070,1705,960,15045,7530,7515,12825,2220
The University of Surrey,15070,5240,2960,2280,2720,2520,9835,7845,1990,8480,1355
The University of Sussex,12450,2660,1830,825,1570,1090,9795,7850,1940,8895,900
The University of Teesside,25405,2980,1375,1605,2595,385,22425,8325,14100,21400,1025
Thames Valley University,18135,2030,565,1465,1530,500,16110,8325,7785,13630,2480
Trinity Laban,880,240,160,75,155,85,640,640,0,515,125
University College London(#11),20990,9070,5975,3090,5570,3500,11920,11275,645,8580,3340
The University of Warwick,28445,8695,3605,5090,5055,3640,19750,10990,8760,16590,3160
"University of the West of England, Bristol",31700,6280,1965,4315,5385,895,25420,18235,7185,23745,1675
The University of Westminster,23225,6190,2885,3305,3555,2635,17035,11190,5845,14220,2815
The University of Winchester,5235,905,120,790,880,25,4330,3595,735,4135,195
The University of Wolverhampton,21305,3760,1250,2510,2630,1130,17545,12080,5465,15630,1915
The University of Worcester,7765,1590,465,1125,1475,115,6175,4255,1920,5875,300
Writtle College,985,0,0,0,0,0,985,750,235,880,105
York St John University,6205,835,200,635,805,30,5370,4250,1120,5245,125
The University of York,13185,3830,2915,915,2075,1755,9355,8010,1340,8385,970
Total Wales,125540,23260,11405,11855,15170,8090,102285,66810,35475,91760,10525
Aberystwyth University,9865,1735,710,1025,1185,550,8130,6085,2045,7375,755
Bangor University,10515,2055,1395,665,1340,715,8460,6630,1835,7690,770
Cardiff University,26585,6765,3430,3335,4295,2470,19820,16050,3770,18150,1670
"University of Wales Institute, Cardiff",9900,2435,1225,1210,1185,1250,7465,6645,820,6875,590
University of Glamorgan(#9),22710,3650,1580,2070,2415,1235,19060,11235,7825,16520,2540
Glynd?r University(#10),7265,635,255,385,405,230,6625,2505,4120,4725,1900
"The University of Wales, Lampeter",7885,995,375,620,560,435,6890,1100,5790,6105,785
"The University of Wales, Newport",9120,1525,455,1070,1210,315,7595,3330,4265,7410,185
Swansea Metropolitan University(#10),5595,1075,500,570,990,85,4520,3055,1465,4190,330
Swansea University,13875,2145,1330,810,1360,785,11730,9050,2685,10800,930
"Trinity College, Carmarthen",2225,245,155,85,220,25,1980,1130,850,1925,55
Total Scotland,210180,51275,26320,24955,33660,17615,158910,123290,35620,142625,16285
The University of Aberdeen,14140,3745,2395,1345,2290,1455,10395,9020,1375,8890,1505
University of Abertay Dundee,4140,585,375,210,200,385,3555,3250,305,2905,650
The University of Dundee,16720,5650,1325,4325,4075,1575,11070,8555,2510,10045,1025
Edinburgh College of Art,1595,210,175,35,80,130,1385,1335,50,1120,265
The University of Edinburgh,23555,6770,4985,1790,4160,2610,16785,16060,725,14620,2165
Glasgow Caledonian University,16770,2685,1335,1350,1720,965,14085,10290,3790,13490,595
Glasgow School of Art,1750,295,255,40,185,110,1455,1385,70,1140,315
The University of Glasgow,23735,5095,2990,2105,3680,1415,18640,14720,3915,17340,1300
Heriot-Watt University,10065,4670,1530,3140,2785,1885,5395,5065,330,4230,1165
Napier University,12995,2305,1070,1230,1370,935,10690,8470,2220,8560,2130
"Queen Margaret University, Edinburgh",5330,1210,385,825,830,380,4120,2935,1185,3730,390
The Robert Gordon University,12265,3500,1610,1890,2020,1480,8765,6610,2155,7815,950
The Royal Scottish Academy of Music and Drama,775,180,170,15,90,90,590,590,0,515,75
The University of St Andrews,8175,1520,1220,300,660,860,6655,5825,830,4915,1740
Scottish Agricultural College,925,125,50,75,70,55,800,670,130,780,20
The University of Stirling,9805,2600,1345,1250,1475,1125,7205,6370,840,6750,455
The University of Strathclyde,21740,8015,4220,3795,6290,1725,13725,11050,2675,12950,775
UHI Millennium Institute,7585,395,100,295,355,40,7190,2845,4340,7065,125
The University of the West of Scotland(#9)(#10),18135,1720,780,940,1320,400,16415,8240,8175,15760,655
Total Northern Ireland,48200,9435,3790,5645,6910,2525,38760,29950,8810,36260,2500
The Queen's University of Belfast,22220,4610,2510,2100,3435,1175,17615,13365,4250,16755,860
St Mary's University College,1040,115,15,100,105,10,925,915,10,895,30
Stranmillis University College,1295,115,20,95,115,0,1180,995,180,1145,35
University of Ulster,23640,4595,1245,3350,3255,1340,19045,14675,4370,17465,1580
,,,,,,,,,,,
